#########
####o####
##A  @ ##
##@    ##
#o     ##
#   @  ##
####  ###
####o####
#########