#######
#A  #o#
#  @  #
#@    #
#o  @o#
#######