#########
##     ##
## ##  ##
#o  #  o#
#    @  #
#  @    #
#   A   #
#########
